1111111111111111111111111
1000000000C10000000000001
1011111001110000000000001
1000110000000100000000001
1P00000010000011100000111
1000000000000001000000001
1000000011000000000000111
100000C0000000000000000E1
1111111111111111111111111
