11111111111111111111111111111111111111111111111111
100000000000000000000000110000000000000000000000C1
1C111110011100000000000011011111001110000000000001
1C0011CCCCC0010000000000110001100000001000000000C1
1P000000100000111000001111000000010000011100000111
100000000000000100000000000000000000000010000000E1
11111111111111111111111111111111111111111111111111
