1111111111111111111111111
1000000000000000000000001
1000000000000000000000001
1000000000000100000000001
1000000000000011100000111
1000000000000001000000001
1000000000000000000000001
1P0000C0000000000000000E1
1111111111111111111111111
