11111111111111111111111111111111111111111111111
1P000000000000000000000000000000000000000000001
10010101010100000000000000000000000010101010101
100000000000000000000000000000000000000000000C1
10010101010100000000000000000000000010101010101
10000000000000000000000000000000000000000000001
10010101010100000000000000000000000010101010101
10000000000000000000001010000000000000000000001
10010101010100000000011011000000000010101010101
10000000000000000001110001110000000000000000001
10010101010100000001000E000100000000101010101C1
10000000000000000001110001110000000000000000001
10010101010100000000011011000000000010101010101
10000000000000000000001110000000000000000000001
10010101010100000000000000000000000010101010101
10000000000000000000000000000000000000000000001
10010101010100000000000000000000000010101010101
100000000000000000000000000000000000000000000C1
10010101010100000000000000000000000010101010101
10000000000000000000000000000000000000000000001
10000000000000000000000000000000000000000000001
11111111111111111111111111111111111111111111111
